program_name	PROGRAM	Iterative Refinement Meta-Assembler (IRMA)
program_version	VERSION	1.0.3
last_git_commit_hash	LAST_COMMIT	91855ac96c0b486dc8622971719c10930b8d2100
sample	RUN	assembly
paired_end_reads	PAIRED	0
data	LEFT	fastq_runid_unknown_0.fastq
module_name	MODULE	FLU
module_param_call	MODULE_CONFIG	FLU-minion
parameter_file_name	PARAM_FILE_NAME	FLU MinION
parameter_file_version	PARAM_FILE_VERSION	1.0
match_last_program	MATCH_PROG	BLAT (-oneOff=1 -minIdentity=80 -tileSize=10)
align_last_program	ALIGN_PROG	BLAT
sort_last_program	SORT_PROG	BLAT
align_last_deletion_type	DEL_TYPE	NNN
assemble_last_program	ASSEM_PROG	SSW (-x 3 -m 2 -o 6 -e 1)
match_programs	MATCH_PROGS	BLAT
sort_programs	SORT_PROGS	BLAT
align_programs	ALIGN_PROGS	SAM BLAT
deletion_types	DEL_TYPES	
blat_identity	BLAT_IDENTITY 80
minimum_blat_match_length	MIN_BLAT_MATCH	0
profiles	phmms	/flu-amd/IRMA_RES/modules/FLU/profiles
do_not_merge_read_pairs	NO_MERGE	0
starting_reference	REF_SET	/flu-amd/IRMA_RES/modules/FLU/reference/consensus.fasta
grid_acceleration_on	GRID_ON	0
grid_optional_path	GRID_PATH	"0"
working_directory	ppath	"/project/nadc_iav/david.hufnagel/4_Purdy/TestingW14Sam/fullPurdyRunNov18/barcode71/david.hufnagel/IRMAv1.0.3/assembly-XDmvveNMtdqJYCoVjS2QwYRHb5tDjmu6"
alternative_frequency	MIN_FA	1
alternative_count	MIN_CA	20
skip_reference_elongation	SKIP_E	1
read_statistic	USE_MEDIAN	0
minimum_statistic_quality	QUAL_THRESHOLD	0
minimum_read_length	MIN_LEN	150
adapter_trim_read_motif	ADAPTER	AGATGTGTATAAGAGACAG
adapter_allow_one_mismatch	FUZZY_ADAPTER	1
enforce_clipped_length	ENFORCE_CLIPPED_LENGTH	0
interval_significance_level	SIG_LEVEL	0.999
maximum_read_gathering_rounds	MAX_ROUNDS	5
read_fasta_input	FASTA	0
minimum_read_patterns	MIN_RP	1
minimum_read_patterns_residual	MIN_RP_RESIDUAL	150
minimum_reads	MIN_RC	1
minimum_reads_residual	MIN_RC_RESIDUAL	150
match_to_altmatch_ratio	RESIDUAL_ASSEMBLY_FACTOR	0
minimum_insertion_edit_threshold	INS_T	0.75
minimum_deletion_edit_threshold	DEL_T	0.75
minimum_insertion_edit_depth	INS_T_DEPTH	1
minimum_deletion_edit_depth	DEL_T_DEPTH	1
silence_complex_indels_for_editing	SILENCE_COMPLEX_INDELS 0
minimum_frequency_for_mixed_consensus_call	MIN_AMBIG	0.20
minimum_consensus_support	MIN_CONS_SUPPORT	50
minimum_consensus_average_quality	MIN_CONS_QUALITY	10
minimum_amplicon_dropout_edge_depth MIN_DROPOUT_EDGE_DEPTH  0
auto_adjust_minimum_variant_frequency	AUTO_F	1
minimum_deletion_variant_frequency	MIN_FD	0.005
minimum_insertion_variant_frequency	MIN_FI	0.005
minimum_variant_frequency	MIN_F	0.008
minimum_variant_count	MIN_C	2
minimum_variant_average_quality	MIN_AQ	8
minimum_variant_depth	MIN_TCC	100
minimum_confidence_not_sequencer_error	MIN_CONF	0.80
merge_secondary_data	MERGE_SECONDARY	0
do_secondary_assembly	DO_SECONDARY 0
final_assembly_to_reference_seed	ASSEM_REF	0
